{
  "resources": {
    "shaders": {
      "sprite": {
        "vert": "resources/shaders/sprite.vert",
        "frag": "resources/shaders/sprite.frag"
      },
      "grid": {
        "vert": "resources/shaders/line.vert",
        "frag": "resources/shaders/line.frag"
      }
    },
    "textures": {
      "dog": "resources/textures/48DogSpriteSheet.png",
      "slime": "resources/textures/Slime.png",
      "skeleton": "resources/textures/Skeleton.png",
      "tilemap": "resources/textures/DesertTilemap16x16.png"
    }
  },
  "tilemapTexture": "resources/textures/DesertTilemap16x16.png",
  "tileSize": { "width": 16, "height": 16 },
  "levelSize": { "width": 224, "height": 240 },

  "font": {
    "path": "resources/fonts/OCRAEXT.TTF",
    "size": 15
  },

  "player": {
    "x": 336,
    "y": 148,
    "scale": 0.6
  },
  "internalWidth": 528,
  "internalHeight": 304,
  "tilemap": [
    [137, 138, 138, 138, 138, 138, 138, 138, 138, 138, 138, 138, 138, 138, 138, 138, 138, 138, 138, 138, 138, 138, 138, 138, 138, 138, 138, 138, 138, 138, 138, 138, 139],
    [151, 152, 152, 152, 152, 152, 152, 152, 152, 152, 152, 152, 152, 152, 152, 152, 152, 152, 152, 152, 152, 152, 152, 152, 152, 152, 152, 152, 152, 152, 152, 152, 153],
    [151, 152, 152, 152, 152, 152, 152, 152, 152, 152, 152, 152, 152, 152, 152, 152, 152, 152, 152, 152, 152, 152, 152, 152, 152, 152, 152, 152, 152, 152, 152, 152, 153],
    [151, 152, 152, 152, 152, 152, 152, 152, 152, 152, 152, 152, 152, 152, 152, 152, 152, 152, 152, 152, 152, 152, 152, 152, 152, 152, 152, 152, 152, 152, 152, 152, 153],
    [151, 152, 152, 152, 152, 152, 152, 152, 152, 152, 152, 152, 152, 152, 152, 152, 152, 152, 152, 152, 152, 152, 152, 152, 152, 152, 152, 152, 152, 152, 152, 152, 153],
    [151, 152, 152, 152, 152, 152, 152, 152, 152, 152, 152, 152, 152, 152, 152, 152, 152, 152, 152, 152, 152, 152, 152, 152, 152, 152, 152, 152, 152, 152, 152, 152, 153],
    [151, 152, 152, 152, 152, 152, 152, 152, 152, 152, 152, 152, 152, 152, 152, 152, 152, 152, 152, 152, 152, 152, 152, 152, 152, 152, 152, 152, 152, 152, 152, 152, 153],
    [151, 152, 152, 152, 152, 152, 152, 152, 152, 152, 152, 152, 152, 152, 152, 152, 152, 152, 152, 152, 152, 152, 152, 152, 152, 152, 152, 152, 152, 152, 152, 152, 153],
    [151, 152, 152, 152, 152, 152, 152, 152, 152, 152, 158, 159, 80, 152, 152, 152, 152, 152, 152, 152, 152, 152, 162, 163, 164, 152, 152, 152, 152, 152, 152, 152, 153],
    [151, 152, 152, 152, 152, 152, 152, 152, 152, 152, 172, 173, 94, 109, 111, 111, 111, 111, 111, 111, 111, 111, 176, 177, 178, 152, 152, 152, 152, 152, 152, 152, 153],
    [151, 152, 152, 152, 152, 152, 152, 152, 152, 152, 106, 107, 108, 152, 152, 152, 152, 152, 152, 152, 152, 152, 106, 107, 108, 152, 152, 152, 152, 152, 152, 152, 153],
    [151, 152, 152, 152, 152, 152, 152, 152, 152, 152, 152, 96, 152, 152, 152, 152, 152, 152, 152, 152, 152, 152, 152, 96, 152, 152, 152, 152, 152, 152, 152, 152, 153],
    [151, 152, 152, 152, 152, 152, 152, 152, 152, 152, 152, 124, 152, 152, 152, 152, 152, 152, 152, 152, 152, 152, 152, 124, 152, 152, 152, 152, 152, 152, 152, 152, 153],
    [151, 152, 152, 152, 152, 152, 152, 152, 152, 152, 152, 124, 152, 152, 152, 152, 152, 152, 152, 152, 152, 152, 152, 124, 152, 152, 152, 152, 152, 152, 152, 152, 153],
    [151, 152, 152, 152, 152, 152, 152, 152, 152, 152, 152, 124, 152, 152, 152, 152, 152, 152, 152, 152, 152, 152, 152, 124, 152, 152, 152, 152, 152, 152, 152, 152, 153],
    [151, 152, 152, 152, 152, 152, 152, 152, 152, 152, 152, 124, 152, 152, 152, 152, 152, 152, 152, 152, 152, 152, 152, 124, 152, 152, 152, 152, 152, 152, 152, 152, 153],
    [151, 152, 152, 152, 152, 152, 152, 152, 152, 152, 152, 124, 152, 152, 152, 152, 54, 54, 54, 152, 152, 152, 152, 124, 152, 152, 152, 152, 152, 152, 152, 152, 153],
    [151, 152, 152, 152, 152, 152, 152, 152, 152, 152, 152, 124, 152, 152, 152, 152, 54, 54, 54, 152, 152, 152, 152, 124, 152, 152, 152, 152, 152, 152, 152, 152, 153],
    [165, 166, 166, 166, 166, 166, 166, 166, 166, 166, 166, 124, 166, 166, 166, 166, 54, 54, 54, 166, 166, 166, 166, 124, 166, 166, 166, 166, 166, 166, 166, 166, 167]
  ],
  "solid": [126, 127, 128, 129, 140, 141, 142, 143, 154, 155, 156, 157, 168, 169, 170, 171, 182, 183, 184, 185, 45, 81, 82, 83, 67, 68, 69, 137, 138, 151, 152],
  "enemies": [
    {
      "type": "slime",
      "x": 100,
      "y": 100,
      "frameX": 0,
      "frameY": 2,
      "frameW": 192,
      "frameH": 96,
      "frameCount": 6,
      "animSpeed": 3,
      "texture": "slime",
      "shader": "sprite"
    },
    {
      "type": "skeleton",
      "x": 159,
      "y": 150,
      "frameX": 7,
      "frameY": 2,
      "frameW": 192,
      "frameH": 320,
      "frameCount": 6,
      "animSpeed": 10,
      "scale": 0.75,
      "texture": "skeleton",
      "shader": "sprite"
    },
    {
      "type": "skeleton",
      "x": 180,
      "y": 150,
      "frameX": 7,
      "frameY": 2,
      "frameW": 192,
      "frameH": 320,
      "frameCount": 6,
      "animSpeed": 10,
      "scale": 0.75,
      "texture": "skeleton",
      "shader": "sprite"
    }
  ]
}
