{
  "resources": {
    "shaders": {
      "sprite": {
        "vert": "resources/shaders/sprite.vert",
        "frag": "resources/shaders/sprite.frag"
      },
      "grid": {
        "vert": "resources/shaders/line.vert",
        "frag": "resources/shaders/line.frag"
      }
    },
    "textures": {
      "dog": "resources/textures/48DogSpriteSheet.png",
      "slime": "resources/textures/Slime.png",
      "skeleton": "resources/textures/Skeleton.png",
      "tilemap": "resources/textures/level2.png"
    }
  },
  "tilemapTexture": "resources/textures/level2.png",
  "tileSize": { "width": 16, "height": 16 },
  "levelSize": { "width": 128, "height": 528 },

  "font": {
    "path": "resources/fonts/OCRAEXT.TTF",
    "size": 15
  },

  "player": {
    "x": 336,
    "y": 148,
    "scale": 0.6,
    "collisionScale": 0.7

  },
  "internalWidth": 720,
  "internalHeight": 400,
  "tileLayers": [
    {
      "name": "Layer_1",
      "collidable": true,
      "tilemap": [
        [194, 173, 194, 194, 185, 185, 194, 194, 194, 185, 185, 194, -1, -1, -1, -1, -1, -1, -1, -1, -1, -1, -1, -1, 207, -1, 29, -1, -1, -1, 29, -1, 205, -1, -1, -1, -1, -1, -1, -1, -1, 229, -1, -1, 211],
        [194, 179, 179, 179, 185, 165, 165, 185, 165, 179, 194, 194, -1, -1, -1, -1, -1, -1, -1, -1, -1, -1, -1, -1, 207, -1, -1, -1, 222, -1, -1, -1, 35, -1, -1, -1, -1, -1, -1, -1, -1, 231, 232, -1, -1],
        [179, 179, 194, 165, 165, 173, 194, 185, 179, 194, 185, 173, -1, -1, -1, -1, -1, -1, -1, -1, -1, -1, -1, -1, 28, -1, 29, -1, 222, -1, 29, -1, 207, -1, -1, -1, -1, -1, -1, -1, -1, 229, -1, -1, -1],
        [179, 194, 203, 173, 194, -1, -1, -1, -1, -1, 185, 194, -1, -1, -1, -1, -1, -1, -1, -1, -1, -1, -1, -1, 207, -1, -1, -1, 222, -1, -1, -1, 205, -1, -1, -1, -1, -1, -1, -1, -1, 228, 230, 233, 230],
        [179, 212, 213, 214, 179, -1, 203, 165, 179, -1, 194, 194, -1, -1, -1, -1, -1, -1, -1, -1, -1, -1, -1, -1, 205, -1, -1, -1, 222, -1, -1, -1, 28, -1, -1, -1, -1, -1, -1, -1, -1, -1, -1, -1, -1],
        [179, 215, 0, 216, 179, -1, 203, 194, 185, -1, 179, 194, -1, 219, -1, -1, -1, -1, -1, -1, -1, -1, -1, -1, 35, 207, 205, 207, 222, 205, 35, 207, 205, -1, -1, -1, -1, -1, -1, -1, -1, -1, -1, -1, -1],
        [173, 217, 25, 218, 173, -1, 165, 165, 194, -1, -1, -1, 220, 221, 221, 221, 221, 221, 221, 221, 221, 221, 221, 221, 221, 221, 221, 221, 227, 221, 221, 221, 221, 223, -1, -1, -1, -1, -1, -1, -1, -1, -1, -1, -1],
        [173, 211, -1, -1, 173, -1, 179, 203, 173, 173, 179, 173, -1, -1, -1, -1, -1, -1, -1, -1, -1, -1, -1, -1, -1, -1, -1, -1, -1, -1, -1, -1, -1, 222, -1, -1, -1, -1, -1, -1, -1, -1, -1, -1, -1],
        [194, -1, -1, -1, 165, -1, 173, 165, 165, 185, 179, 179, -1, -1, -1, -1, -1, -1, -1, -1, -1, -1, -1, -1, -1, -1, -1, -1, -1, -1, -1, -1, -1, 222, -1, -1, -1, -1, -1, -1, -1, -1, -1, -1, -1],
        [173, -1, 207, -1, -1, -1, 165, 165, 173, 179, 179, 173, -1, -1, -1, -1, -1, -1, -1, -1, -1, -1, -1, -1, -1, -1, -1, -1, -1, -1, -1, -1, -1, 222, -1, -1, -1, -1, -1, -1, -1, -1, -1, -1, -1],
        [194, 165, 179, 179, 194, 179, 173, 173, 203, 179, 194, 179, -1, -1, -1, -1, -1, -1, -1, -1, -1, -1, -1, -1, -1, -1, -1, -1, -1, -1, -1, -1, -1, 222, -1, -1, -1, -1, -1, -1, -1, -1, -1, -1, -1],
        [194, 165, 203, 185, 165, 165, 203, 179, 179, 185, 185, 179, -1, -1, -1, -1, -1, -1, -1, -1, -1, -1, -1, -1, -1, -1, -1, -1, -1, -1, -1, -1, -1, 222, -1, -1, -1, -1, -1, -1, -1, -1, -1, -1, -1],
        [194, 165, 165, 194, 165, 203, 194, 165, 165, 194, 179, 194, -1, -1, -1, -1, -1, -1, -1, -1, -1, -1, -1, -1, -1, -1, -1, -1, -1, -1, -1, -1, -1, 222, -1, -1, -1, -1, -1, -1, -1, -1, -1, -1, -1],
        [-1, -1, -1, -1, -1, -1, -1, -1, -1, -1, -1, -1, -1, -1, -1, -1, -1, -1, -1, -1, -1, -1, -1, -1, -1, -1, -1, -1, -1, -1, -1, -1, -1, 222, -1, -1, -1, -1, -1, -1, -1, -1, -1, -1, -1],
        [-1, -1, -1, -1, -1, -1, -1, -1, -1, -1, -1, -1, -1, -1, -1, -1, -1, -1, -1, -1, -1, -1, -1, -1, -1, -1, -1, -1, -1, -1, -1, -1, -1, 222, -1, -1, -1, -1, -1, -1, -1, -1, -1, -1, -1],
        [-1, -1, -1, -1, -1, -1, -1, -1, -1, -1, -1, -1, -1, -1, -1, -1, -1, -1, -1, -1, -1, -1, -1, -1, -1, -1, -1, -1, -1, -1, -1, -1, 254, 222, 255, -1, -1, -1, -1, -1, -1, -1, -1, -1, -1],
        [42, -1, -1, -1, 42, -1, -1, -1, -1, -1, -1, -1, -1, -1, -1, -1, -1, -1, -1, -1, -1, -1, -1, -1, -1, -1, -1, -1, -1, -1, -1, -1, -1, 222, -1, -1, -1, -1, -1, -1, -1, -1, -1, -1, -1],
        [-1, -1, -1, -1, -1, -1, -1, -1, -1, -1, -1, -1, -1, -1, -1, -1, -1, -1, -1, -1, -1, -1, -1, -1, -1, -1, -1, -1, -1, -1, -1, -1, 253, 222, 252, -1, -1, -1, -1, -1, -1, -1, -1, -1, -1],
        [16, 16, 16, 16, 16, 16, 17, -1, 209, -1, -1, -1, -1, -1, -1, -1, -1, -1, -1, -1, -1, -1, -1, -1, -1, -1, -1, -1, -1, -1, -1, -1, -1, 222, -1, -1, -1, -1, -1, -1, -1, -1, -1, -1, -1],
        [19, 19, 19, 19, 19, 19, 20, -1, -1, -1, -1, -1, -1, -1, -1, -1, -1, -1, -1, -1, -1, -1, -1, -1, -1, -1, -1, -1, -1, -1, -1, -1, 253, 222, 252, -1, -1, -1, -1, -1, -1, -1, -1, -1, -1],
        [246, 246, 246, 246, 245, 19, 20, -1, -1, -1, -1, -1, -1, -1, -1, -1, 85, 59, 154, 155, 59, 86, -1, -1, -1, -1, -1, -1, -1, -1, -1, -1, -1, 222, -1, -1, -1, -1, -1, -1, -1, -1, -1, -1, -1],
        [239, 239, 239, 225, 225, 225, 224, -1, -1, -1, -1, -1, -1, -1, -1, -1, 260, -1, -1, -1, -1, 260, -1, -1, -1, -1, -1, -1, -1, -1, -1, -1, 253, 222, 252, -1, -1, -1, -1, -1, -1, -1, -1, -1, -1],
        [239, 239, 239, 239, 247, 19, 20, -1, -1, -1, -1, -1, -1, -1, -1, -1, 260, -1, -1, -1, -1, 260, -1, -1, -1, -1, -1, -1, -1, -1, -1, -1, -1, 222, -1, -1, -1, -1, -1, -1, -1, -1, -1, -1, -1],
        [239, 239, 239, 239, 247, 19, 20, -1, 226, -1, -1, -1, -1, -1, -1, -1, 260, -1, 256, 257, -1, 260, -1, -1, -1, -1, -1, -1, -1, -1, -1, -1, -1, 222, -1, -1, -1, -1, -1, -1, -1, -1, -1, -1, -1],
        [239, 239, 239, 239, 247, 19, 20, -1, -1, -1, -1, -1, -1, -1, -1, -1, 260, -1, 258, 259, -1, 260, -1, -1, -1, -1, -1, -1, -1, -1, -1, -1, -1, 222, -1, -1, -1, -1, -1, -1, -1, -1, -1, -1, -1]
      ]
    },
    {
      "name": "Layer_0",
      "collidable": false,
      "tilemap": [
        [4, 4, 4, 4, 4, 4, 4, 4, 4, 4, 4, 4, 4, 4, 4, 4, 4, 4, 4, 4, 4, 4, 4, 4, 4, 4, 4, 4, 4, 4, 4, 4, 4, 4, 4, 4, 4, 4, 4, 4, 4, 4, 4, 4, 4],
        [4, 4, 4, 4, 4, 4, 4, 4, 4, 4, 4, 4, 4, 4, 4, 4, 4, 4, 4, 4, 4, 4, 4, 4, 4, 4, 4, 4, 4, 4, 4, 4, 4, 4, 4, 4, 4, 4, 4, 4, 4, 4, 4, 4, 4],
        [4, 4, 4, 4, 4, 4, 4, 4, 4, 2, 2, 4, 4, 4, 4, 4, 4, 4, 4, 4, 4, 4, 4, 4, 4, 4, 6, 6, 6, 6, 6, 6, 6, 4, 6, 6, 6, 6, 6, 6, 4, 4, 4, 4, 4],
        [4, 4, 4, 4, 4, 2, 2, 2, 2, 2, 2, 2, 2, 2, 2, 4, 4, 4, 4, 4, 4, 4, 4, 4, 6, 6, 6, 4, 4, 4, 4, 4, 4, 4, 4, 4, 4, 4, 6, 6, 4, 4, 4, 4, 4],
        [4, 4, 4, 4, 2, 5, 2, 2, 4, 4, 4, 2, 2, 2, 6, 6, 2, 6, 4, 6, 6, 4, 6, 6, 6, 6, 4, 4, 4, 6, 6, 6, 6, 6, 6, 6, 6, 6, 6, 6, 6, 4, 4, 4, 4],
        [4, 4, 4, 2, 2, 2, 4, 5, 5, 6, 6, 5, 4, 2, 6, 4, 6, 2, 4, 4, 4, 4, 4, 4, 6, 4, 6, 6, 6, 6, 6, 6, 6, 6, 6, 4, 4, 4, 4, 4, 6, 4, 4, 4, 4],
        [4, 4, 5, 2, 2, 4, 4, 4, 4, 4, 4, 4, 2, 2, 6, 5, 6, 4, 2, 2, 4, 4, 4, 4, 6, 4, 6, 6, 6, 6, 6, 6, 6, 4, 4, 4, 4, 4, 4, 4, 6, 6, 4, 4, 4],
        [4, 4, 5, 2, 2, 4, 4, 4, 2, 2, 2, 2, 2, 6, 2, 2, 2, 2, 6, 2, 4, 6, 4, 4, 6, 6, 6, 6, 6, 6, 6, 6, 6, 4, 4, 4, 4, 4, 4, 4, 4, 6, 4, 4, 4],
        [4, 4, 4, 2, 2, 2, 2, 2, 4, 6, 6, 6, 2, 6, 2, 6, 4, 6, 6, 2, 4, 4, 6, 6, 2, 6, 5, 4, 4, 6, 6, 6, 6, 6, 4, 4, 4, 4, 4, 4, 4, 6, 6, 4, 4],
        [4, 4, 4, 2, 5, 4, 4, 4, 6, 4, 6, 6, 6, 6, 2, 2, 2, 2, 2, 6, 6, 2, 2, 6, 2, 5, 6, 6, 2, 4, 4, 6, 6, 6, 4, 4, 4, 4, 4, 4, 4, 6, 6, 4, 4],
        [4, 4, 4, 6, 2, 4, 5, 6, 6, 6, 6, 6, 6, 6, 6, 6, 6, 6, 4, 6, 2, 6, 6, 5, 5, 2, 2, 4, 4, 6, 6, 2, 6, 6, 6, 6, 6, 4, 6, 6, 6, 4, 4, 4, 4],
        [4, 4, 4, 6, 6, 6, 6, 6, 4, 6, 6, 6, 6, 6, 6, 4, 6, 6, 6, 6, 6, 6, 6, 4, 6, 4, 4, 4, 5, 5, 5, 5, 5, 6, 6, 5, 4, 4, 4, 4, 4, 4, 4, 4, 4],
        [4, 4, 4, 4, 5, 4, 2, 2, 6, 6, 6, 6, 6, 6, 6, 6, 6, 6, 6, 6, 6, 6, 4, 4, 4, 6, 4, 5, 4, 5, 6, 6, 6, 6, 6, 6, 6, 6, 6, 4, 4, 4, 4, 4, 4],
        [4, 4, 4, 4, 4, 4, 6, 4, 4, 2, 6, 6, 6, 6, 4, 5, 6, 6, 4, 2, 6, 6, 6, 6, 4, 6, 6, 6, 6, 5, 6, 6, 5, 5, 6, 6, 6, 4, 4, 6, 4, 4, 4, 4, 4],
        [4, 4, 4, 6, 4, 5, 4, 4, 5, 6, 2, 6, 6, 6, 6, 6, 6, 6, 6, 4, 6, 6, 6, 4, 4, 4, 4, 4, 4, 6, 6, 6, 6, 6, 6, 6, 4, 4, 4, 4, 6, 4, 4, 4, 4],
        [4, 4, 6, 4, 4, 4, 4, 5, 4, 6, 6, 6, 6, 6, 4, 4, 4, 6, 6, 6, 6, 6, 6, 4, 4, 4, 4, 3, 3, 6, 6, 6, 6, 6, 6, 6, 6, 6, 5, 4, 4, 6, 4, 4, 4],
        [249, 249, 249, 249, 249, 249, 249, 249, 250, 2, 4, 4, 4, 4, 6, 6, 6, 6, 4, 6, 6, 3, 3, 6, 3, 6, 6, 6, 6, 6, 2, 2, 4, 4, 2, 6, 6, 6, 6, 6, 4, 4, 6, 4, 4],
        [248, 248, 248, 248, 248, 248, 248, 248, 251, 2, 4, 4, 4, 4, 4, 4, 5, 4, 4, 6, 6, 6, 6, 6, 4, 6, 3, 3, 3, 3, 3, 4, 2, 2, 2, 6, 6, 5, 5, 6, 6, 4, 4, 6, 4],
        [16, 16, 16, 16, 16, 16, 17, 248, 251, 4, 2, 2, 4, 5, 5, 5, 5, 4, 6, 6, 6, 6, 2, 3, 3, 2, 6, 2, 6, 6, 2, 2, 4, 4, 4, 4, 6, 2, 6, 6, 6, 6, 4, 6, 4],
        [19, 19, 19, 19, 19, 19, 20, 248, 251, 4, 4, 2, 2, 2, 4, 2, 2, 2, 2, 2, 2, 2, 4, 4, 3, 3, 3, 5, 5, 5, 6, 6, 6, 6, 6, 6, 6, 2, 2, 4, 4, 6, 4, 6, 4],
        [237, 237, 237, 237, 244, 19, 20, 248, 251, 5, 5, 5, 4, 4, 4, 4, 4, 5, 4, 5, 4, 4, 5, 2, 3, 3, 4, 6, 6, 6, 6, 6, 6, 6, 6, 6, 2, 2, 4, 6, 4, 4, 6, 6, 6],
        [239, 239, 239, 239, 238, 19, 20, 248, 251, 4, 6, 4, 4, 6, 4, 4, 6, 4, 5, 5, 5, 5, 5, 2, 2, 4, 4, 4, 4, 4, 4, 6, 6, 6, 2, 2, 2, 4, 6, 4, 6, 4, 2, 2, 6],
        [239, 239, 239, 239, 238, 19, 20, 248, 251, 4, 4, 4, 4, 4, 4, 4, 4, 4, 4, 4, 4, 4, 4, 4, 4, 2, 2, 2, 2, 2, 2, 2, 2, 2, 2, 6, 6, 6, 6, 4, 4, 2, 2, 2, 4],
        [239, 239, 239, 239, 238, 19, 20, 248, 251, 4, 4, 4, 4, 4, 4, 4, 4, 4, 4, 4, 4, 4, 4, 4, 4, 4, 4, 4, 4, 4, 4, 4, 4, 4, 4, 4, 4, 4, 4, 4, 4, 6, 2, 2, 4],
        [239, 239, 239, 239, 238, 19, 20, 248, 251, 4, 4, 4, 4, 4, 4, 4, 4, 4, 4, 4, 4, 4, 4, 4, 4, 4, 4, 4, 4, 4, 4, 4, 4, 4, 4, 4, 4, 4, 4, 4, 4, 4, 4, 4, 4]
      ]
    }
  ],
  "solid": [85,260,59,154,155,256,257,258,259,253,252,254,255,246,239,238,247,245,19,20,17,16,239, 238, 19, 236, 237, 244, 234,235,194,173,185,179,207,211,25,217,215,212,213,214,216,218,219,203,165,35,207,205,28,29,229,228,229, 230,42,226,209],
  "enemies": [
    {
      "type": "slime",
      "x": 40,
      "y": 125,
      "frameX": 0,
      "frameY": 2,
      "frameW": 192,
      "frameH": 96,
      "frameCount": 6,
      "animSpeed": 3,
      "scale": 0.75,
      "collisionScale": 0.4,
      "texture": "slime",
      "shader": "sprite"
    },
    {
      "type": "skeleton",
      "x": 400,
      "y": 105,
      "frameX": 7,
      "frameY": 2,
      "frameW": 192,
      "frameH": 320,
      "frameCount": 6,
      "animSpeed": 10,
      "scale": 0.75,
      "collisionScale": 0.4,
      "texture": "skeleton",
      "shader": "sprite"
    }
  ]
}
