{
  "tileLayers": [
    {
      "name": "Layer_1",
      "tilemap": [
        [-1, -1, -1, -1, -1, -1, -1, -1, -1, -1, -1, -1, -1, -1, -1, -1, -1, -1, -1, -1, -1, -1],
        [-1, -1, -1, -1, -1, -1, -1, -1, -1, -1, -1, -1, -1, -1, -1, -1, -1, -1, -1, -1, -1, -1],
        [-1, -1, -1, -1, 161, 161, 161, 161, 161, 161, 161, 161, 161, 161, 161, 161, 161, 161, -1, -1, -1, -1],
        [-1, -1, -1, -1, 161, 161, 161, 161, 161, 161, 161, 161, 161, 161, 161, 161, 161, 161, -1, -1, -1, -1],
        [-1, -1, -1, -1, 161, 161, 161, 161, 161, 161, 161, 161, 161, 161, 161, 161, 161, 161, -1, -1, -1, -1],
        [-1, -1, -1, -1, -1, -1, -1, -1, -1, -1, -1, -1, -1, -1, -1, -1, -1, -1, -1, -1, -1, -1],
        [-1, -1, -1, 204, 205, 28, 29, 30, 31, -1, 204, 205, 28, 29, 30, 31, -1, -1, -1, -1, -1, -1],
        [-1, -1, -1, 206, 207, 35, 36, 37, 38, 204, 206, 207, 35, 36, 37, 38, -1, -1, -1, -1, -1, -1],
        [-1, -1, -1, 208, 209, 42, 43, 44, 45, 204, 208, 209, 42, 43, 44, 45, -1, -1, -1, -1, -1, -1],
        [-1, -1, -1, 210, 211, 49, 50, 44, 45, 204, 210, 211, 49, 50, 44, 45, -1, 12, 109, 110, 111, 112],
        [-1, -1, -1, -1, -1, -1, -1, -1, -1, -1, -1, -1, -1, -1, -1, -1, -1, 13, 126, 127, 128, 129]
      ]
    },
    {
      "name": "Layer_0",
      "tilemap": [
        [0, 0, 0, 0, 0, 0, 0, 0, 0, 0, 0, 0, 0, 0, 0, 0, 0, 0, 0, 0, 0, 0],
        [0, 0, 0, 0, 0, 0, 0, 0, 0, 0, 0, 0, 0, 0, 0, 0, 0, 0, 0, 0, 0, 0],
        [0, 0, 0, 0, 0, 0, 0, 0, 0, 0, 0, 0, 0, 0, 0, 0, 0, 0, 0, 0, 0, 0],
        [0, 0, 0, 0, 0, 0, 0, 0, 0, 0, 0, 0, 0, 0, 0, 0, 0, 0, 0, 0, 0, 0],
        [0, 0, 0, 0, 0, 0, 0, 0, 0, 0, 0, 0, 0, 0, 0, 0, 0, 0, 0, 0, 0, 0],
        [0, 0, 0, 0, 0, 0, 0, 0, 0, 0, 0, 0, 0, 0, 0, 0, 0, 0, 0, 0, 0, 0],
        [0, 0, 0, 0, 0, 0, 0, 0, 0, 0, 0, 0, 0, 0, 0, 0, 0, 0, 0, 0, 0, 0],
        [0, 0, 0, 0, 0, 0, 0, 0, 0, 0, 0, 0, 0, 0, 0, 0, 0, 0, 0, 0, 0, 0],
        [0, 0, 0, 0, 0, 0, 0, 0, 0, 0, 0, 0, 0, 0, 0, 0, 0, 0, 0, 0, 0, 0],
        [0, 0, 0, 0, 0, 0, 0, 0, 0, 0, 0, 0, 0, 0, 0, 0, 0, 0, 0, 0, 0, 0],
        [0, 0, 0, 0, 0, 0, 0, 0, 0, 0, 0, 0, 0, 0, 0, 0, 0, 0, 0, 0, 0, 0],
        [0, 0, 0, 0, 0, 0, 0, 0, 0, 0, 0, 0, 0, 0, 0, 0, 0, 0, 0, 0, 0, 0]
      ]
    }
  ]
}
